# https://specifications.freedesktop.org/icon-naming-spec/icon-naming-spec-latest.html, aggregate list from each section
address-book-new	The icon used for the action to create a new address book.
application-exit	The icon used for exiting an application. Typically this is seen in the application's menus as File->Quit.
appointment-new	The icon used for the action to create a new appointment in a calendaring application.
call-start	The icon used for initiating or accepting a call. Should be similar to the standard cellular call pickup icon, a green handset with ear and mouth pieces facing upward.
call-stop	The icon used for stopping a current call. Should be similar to the standard cellular call hangup icon, a red handset with ear and mouth pieces facing downward.
contact-new	The icon used for the action to create a new contact in an address book application.
document-new	The icon used for the action to create a new document.
document-open	The icon used for the action to open a document.
document-open-recent	The icon used for the action to open a document that was recently opened.
document-page-setup	The icon for the page setup action of a document editor.
document-print	The icon for the print action of an application.
document-print-preview	The icon for the print preview action of an application.
document-properties	The icon for the action to view the properties of a document in an application.
document-revert	The icon for the action of reverting to a previous version of a document.
document-save	The icon for the save action. Should be an arrow pointing down and toward a hard disk.
document-save-as	The icon for the save as action.
document-send	The icon for the send action. Should be an arrow pointing up and away from a hard disk.
edit-clear	The icon for the clear action.
edit-copy	The icon for the copy action.
edit-cut	The icon for the cut action.
edit-delete	The icon for the delete action.
edit-find	The icon for the find action.
edit-find-replace	The icon for the find and replace action.
edit-paste	The icon for the paste action.
edit-redo	The icon for the redo action.
edit-select-all	The icon for the select all action.
edit-undo	The icon for the undo action.
folder-new	The icon for creating a new folder.
format-indent-less	The icon for the decrease indent formatting action.
format-indent-more	The icon for the increase indent formatting action.
format-justify-center	The icon for the center justification formatting action.
format-justify-fill	The icon for the fill justification formatting action.
format-justify-left	The icon for the left justification formatting action.
format-justify-right	The icon for the right justification action.
format-text-direction-ltr	The icon for the left-to-right text formatting action.
format-text-direction-rtl	The icon for the right-to-left formatting action.
format-text-bold	The icon for the bold text formatting action.
format-text-italic	The icon for the italic text formatting action.
format-text-underline	The icon for the underlined text formatting action.
format-text-strikethrough	The icon for the strikethrough text formatting action.
go-bottom	The icon for the go to bottom of a list action.
go-down	The icon for the go down in a list action.
go-first	The icon for the go to the first item in a list action.
go-home	The icon for the go to home location action.
go-jump	The icon for the jump to action.
go-last	The icon for the go to the last item in a list action.
go-next	The icon for the go to the next item in a list action.
go-previous	The icon for the go to the previous item in a list action.
go-top	The icon for the go to the top of a list action.
go-up	The icon for the go up in a list action.
help-about	The icon for the About item in the Help menu.
help-contents	The icon for Contents item in the Help menu.
help-faq	The icon for the FAQ item in the Help menu.
insert-image	The icon for the insert image action of an application.
insert-link	The icon for the insert link action of an application.
insert-object	The icon for the insert object action of an application.
insert-text	The icon for the insert text action of an application.
list-add	The icon for the add to list action.
list-remove	The icon for the remove from list action.
mail-forward	The icon for the forward action of an electronic mail application.
mail-mark-important	The icon for the mark as important action of an electronic mail application.
mail-mark-junk	The icon for the mark as junk action of an electronic mail application.
mail-mark-notjunk	The icon for the mark as not junk action of an electronic mail application.
mail-mark-read	The icon for the mark as read action of an electronic mail application.
mail-mark-unread	The icon for the mark as unread action of an electronic mail application.
mail-message-new	The icon for the compose new mail action of an electronic mail application.
mail-reply-all	The icon for the reply to all action of an electronic mail application.
mail-reply-sender	The icon for the reply to sender action of an electronic mail application.
mail-send	The icon for the send action of an electronic mail application.
mail-send-receive	The icon for the send and receive action of an electronic mail application.
media-eject	The icon for the eject action of a media player or file manager.
media-playback-pause	The icon for the pause action of a media player.
media-playback-start	The icon for the start playback action of a media player.
media-playback-stop	The icon for the stop action of a media player.
media-record	The icon for the record action of a media application.
media-seek-backward	The icon for the seek backward action of a media player.
media-seek-forward	The icon for the seek forward action of a media player.
media-skip-backward	The icon for the skip backward action of a media player.
media-skip-forward	The icon for the skip forward action of a media player.
object-flip-horizontal	The icon for the action to flip an object horizontally.
object-flip-vertical	The icon for the action to flip an object vertically.
object-rotate-left	The icon for the rotate left action performed on an object.
object-rotate-right	The icon for the rotate rigt action performed on an object.
process-stop	The icon used for the “Stop” action in applications with actions that may take a while to process, such as web page loading in a browser.
system-lock-screen	The icon used for the “Lock Screen” item in the desktop's panel application.
system-log-out	The icon used for the “Log Out” item in the desktop's panel application.
system-run	The icon used for the “Run Application...” item in the desktop's panel application.
system-search	The icon used for the “Search” item in the desktop's panel application.
system-reboot	The icon used for the “Reboot” item in the desktop's panel application.
system-shutdown	The icon used for the “Shutdown” item in the desktop's panel application.
tools-check-spelling	The icon used for the “Check Spelling” item in the application's “Tools” menu.
view-fullscreen	The icon used for the “Fullscreen” item in the application's “View” menu.
view-refresh	The icon used for the “Refresh” item in the application's “View” menu.
view-restore	The icon used by an application for leaving the fullscreen view, and returning to a normal windowed view.
view-sort-ascending	The icon used for the “Sort Ascending” item in the application's “View” menu, or in a button for changing the sort method for a list.
view-sort-descending	The icon used for the “Sort Descending” item in the application's “View” menu, or in a button for changing the sort method for a list.
window-close	The icon used for the “Close Window” item in the application's “Windows” menu.
window-new	The icon used for the “New Window” item in the application's “Windows” menu.
zoom-fit-best	The icon used for the “Best Fit” item in the application's “View” menu.
zoom-in	The icon used for the “Zoom in” item in the application's “View” menu.
zoom-original	The icon used for the “Original Size” item in the application's “View” menu.
zoom-out	The icon used for the “Zoom Out” item in the application's “View” menu.
process-working	This is the standard spinner animation for web browsers and file managers to show that the location is loading.
accessories-calculator	The icon used for the desktop's calculator accessory program.
accessories-character-map	The icon used for the desktop's international and extended text character accessory program.
accessories-dictionary	The icon used for the desktop's dictionary accessory program.
accessories-text-editor	The icon used for the desktop's text editing accessory program.
help-browser	The icon used for the desktop's help browsing application.
multimedia-volume-control	The icon used for the desktop's hardware volume control application.
preferences-desktop-accessibility	The icon used for the desktop's accessibility preferences.
preferences-desktop-font	The icon used for the desktop's font preferences.
preferences-desktop-keyboard	The icon used for the desktop's keyboard preferences.
preferences-desktop-locale	The icon used for the desktop's locale preferences.
preferences-desktop-multimedia	The icon used for the desktop's multimedia preferences.
preferences-desktop-screensaver	The icon used for the desktop's screen saving preferences.
preferences-desktop-theme	The icon used for the desktop's theme preferences.
preferences-desktop-wallpaper	The icon used for the desktop's wallpaper preferences.
system-file-manager	The icon used for the desktop's file management application.
system-software-install	The icon used for the desktop's software installer application.
system-software-update	The icon used for the desktop's software updating application.
utilities-system-monitor	The icon used for the desktop's system resource monitor application.
utilities-terminal	The icon used for the desktop's terminal emulation application.
applications-accessories	The icon for the “Accessories” sub-menu of the Programs menu.
applications-development	The icon for the “Programming” sub-menu of the Programs menu.
applications-engineering	The icon for the “Engineering” sub-menu of the Programs menu.
applications-games	The icon for the “Games” sub-menu of the Programs menu.
applications-graphics	The icon for the “Graphics” sub-menu of the Programs menu.
applications-internet	The icon for the “Internet” sub-menu of the Programs menu.
applications-multimedia	The icon for the “Multimedia” sub-menu of the Programs menu.
applications-office	The icon for the “Office” sub-menu of the Programs menu.
applications-other	The icon for the “Other” sub-menu of the Programs menu.
applications-science	The icon for the “Science” sub-menu of the Programs menu.
applications-system	The icon for the “System Tools” sub-menu of the Programs menu.
applications-utilities	The icon for the “Utilities” sub-menu of the Programs menu.
preferences-desktop	The icon for the “Desktop Preferences” category.
preferences-desktop-peripherals	The icon for the “Peripherals” sub-category of the “Desktop Preferences” category.
preferences-desktop-personal	The icon for the “Personal” sub-category of the “Desktop Preferences” category.
preferences-other	The icon for the “Other” preferences category.
preferences-system	The icon for the “System Preferences” category.
preferences-system-network	The icon for the “Network” sub-category of the “System Preferences” category.
system-help	The icon for the “Help” system category.
audio-card	The icon used for the audio rendering device.
audio-input-microphone	The icon used for the microphone audio input device.
battery	The icon used for the system battery device.
camera-photo	The icon used for a digital still camera devices.
camera-video	The fallback icon for video cameras.
camera-web	The fallback icon for web cameras.
computer	The icon used for the computing device as a whole.
drive-harddisk	The icon used for hard disk drives.
drive-optical	The icon used for optical media drives such as CD and DVD.
drive-removable-media	The icon used for removable media drives.
input-gaming	The icon used for the gaming input device.
input-keyboard	The icon used for the keyboard input device.
input-mouse	The icon used for the mousing input device.
input-tablet	The icon used for graphics tablet input devices.
media-flash	The fallback icon used for flash media, such as memory stick and SD.
media-floppy	The icon used for physical floppy disk media.
media-optical	The icon used for physical optical media such as CD and DVD.
media-tape	The icon used for generic physical tape media.
modem	The icon used for modem devices.
multimedia-player	The icon used for generic multimedia playing devices.
network-wired	The icon used for wired network connections.
network-wireless	The icon used for wireless network connections.
pda	This is the fallback icon for Personal Digial Assistant devices. Primary use of this icon is for PDA devices connected to the PC. Connection medium is not an important aspect of the icon. The metaphor for this fallback icon should be a generic PDA device icon.
phone	This is the default fallback for phone devices. Primary use of this icon group is for phone devices which support connectivity to the PC. These may be VoIP, cellular, or possibly landline phones. The metaphor for this fallback should be a generic mobile phone device.
printer	The icon used for a printer device.
scanner	The icon used for a scanner device.
video-display	The icon used for the monitor that video gets displayed to.
emblem-default	The icon used as an emblem to specify the default selection of a printer for example.
emblem-documents	The icon used as an emblem for the directory where a user's documents are stored.
emblem-downloads	The icon used as an emblem for the directory where a user's downloads from the internet are stored.
emblem-favorite	The icon used as an emblem for files and directories that the user marks as favorites.
emblem-important	The icon used as an emblem for files and directories that are marked as important by the user.
emblem-mail	The icon used as an emblem to specify the directory where the user's electronic mail is stored.
emblem-photos	The icon used as an emblem to specify the directory where the user stores photographs.
emblem-readonly	The icon used as an emblem for files and directories which can not be written to by the user.
emblem-shared	The icon used as an emblem for files and directories that are shared to other users.
emblem-symbolic-link	The icon used as an emblem for files and direcotires that are links to other files or directories on the filesystem.
emblem-synchronized	The icon used as an emblem for files or directories that are configured to be synchronized to another device.
emblem-system	The icon used as an emblem for directories that contain system libraries, settings, and data.
emblem-unreadable	The icon used as an emblem for files and directories that are inaccessible.
face-angel	The icon used for the 0:-) emote.
face-angry	The icon used for the X-( emote.
face-cool	The icon used for the B-) emote.
face-crying	The icon used for the :'( emote.
face-devilish	The icon used for the >:-) emote.
face-embarrassed	The icon used for the :-[ emote.
face-kiss	The icon used for the :-* emote.
face-laugh	The icon used for the :-)) emote.
face-monkey	The icon used for the :-(|) emote.
face-plain	The icon used for the :-| emote.
face-raspberry	The icon used for the :-P emote.
face-sad	The icon used for the :-( emote.
face-sick	The icon used for the :-& emote.
face-smile	The icon used for the :-) emote.
face-smile-big	The icon used for the :-D emote.
face-smirk	The icon used for the :-! emote.
face-surprise	The icon used for the :-0 emote.
face-tired	The icon used for the |-) emote.
face-uncertain	The icon used for the :-/ emote.
face-wink	The icon used for the ;-) emote.
face-worried	The icon used for the :-S emote.
flag-aa	The flag for the country with the ISO 3166 country code AA. All flags should use ISO 3166 two-letter country codes, in lowercase form, as the specifier for the country.
application-x-executable	The icon used for executable file types.
audio-x-generic	The icon used for generic audio file types.
font-x-generic	The icon used for generic font file types.
image-x-generic	The icon used for generic image file types.
package-x-generic	The icon used for generic package file types.
text-html	The icon used for HTML text file types.
text-x-generic	The icon used for generic text file types.
text-x-generic-template	The icon used for generic text templates.
text-x-script	The icon used for script file types, such as shell scripts.
video-x-generic	The icon used for generic video file types.
x-office-address-book	The icon used for generic address book file types.
x-office-calendar	The icon used for generic calendar file types.
x-office-document	The icon used for generic document and letter file types.
x-office-presentation	The icon used for generic presentation file types.
x-office-spreadsheet	The icon used for generic spreadsheet file types.
folder	The standard folder icon used to represent directories on local filesystems, mail folders, and other hierarchical groups.
folder-remote	The icon used for normal directories on a remote filesystem.
network-server	The icon used for individual host machines under the “Network Servers” place in the file manager.
network-workgroup	The icon for the “Network Servers” place in the desktop's file manager, and workgroups within the network.
start-here	The icon used by the desktop's main menu for accessing places, applications, and other features.
user-bookmarks	The icon for the user's special “Bookmarks” place.
user-desktop	The icon for the special “Desktop” directory of the user.
user-home	The icon for the special “Home” directory of the user.
user-trash	The icon for the user's “Trash” place in the desktop's file manager.
appointment-missed	The icon used when an appointment was missed.
appointment-soon	The icon used when an appointment will occur soon.
audio-volume-high	The icon used to indicate high audio volume.
audio-volume-low	The icon used to indicate low audio volume.
audio-volume-medium	The icon used to indicate medium audio volume.
audio-volume-muted	The icon used to indicate the muted state for audio playback.
battery-caution	The icon used when the battery is below 40%.
battery-low	The icon used when the battery is below 20%.
dialog-error	The icon used when a dialog is opened to explain an error condition to the user.
dialog-information	The icon used when a dialog is opened to give information to the user that may be pertinent to the requested action.
dialog-password	The icon used when a dialog requesting the authentication credentials for a user is opened.
dialog-question	The icon used when a dialog is opened to ask a simple question of the user.
dialog-warning	The icon used when a dialog is opened to warn the user of impending issues with the requested action.
folder-drag-accept	The icon used for a folder while an object is being dragged onto it, that is of a type that the directory can contain.
folder-open	The icon used for folders, while their contents are being displayed within the same window. This icon would normally be shown in a tree or list view, next to the main view of a folder's contents.
folder-visiting	The icon used for folders, while their contents are being displayed in another window. This icon would typically be used when using multiple windows to navigate the hierarchy, such as in Nautilus's spatial mode.
image-loading	The icon used when another image is being loaded, such as thumnails for larger images in the file manager.
image-missing	The icon used when another image could not be loaded.
mail-attachment	The icon used for an electronic mail that contains attachments.
mail-unread	The icon used for an electronic mail that is unread.
mail-read	The icon used for an electronic mail that is read.
mail-replied	The icon used for an electronic mail that has been replied to.
mail-signed	The icon used for an electronic mail that contains a signature.
mail-signed-verified	The icon used for an electronic mail that contains a signature which has also been verified by the security system.
media-playlist-repeat	The icon for the repeat mode of a media player.
media-playlist-shuffle	The icon for the shuffle mode of a media player.
network-error	The icon used when an error occurs trying to intialize the network connection of the computing device. This icon should be two computers, one in the background, with the screens of both computers, colored black, and with the theme's style element for errors, overlayed on top of the icon.
network-idle	The icon used when no data is being transmitted or received, while the computing device is connected to a network. This icon should be two computers, one in the background, with the screens of both computers, colored black.
network-offline	The icon used when the computing device is disconnected from the network. This icon should be a computer in the background, with a screen colored black, and the theme's icon element to show that a device is not accessible, in the foreground.
network-receive	The icon used when data is being received, while the computing device is connected to a network. This icon should be two computers, one in the background, with its screen colored green, and the screen of the computer in the foreground, colored black.
network-transmit	The icon used when data is being transmitted, while the computing device is connected to a network. This icon should be two computers, one in the background, with its screen colored black, and the screen of the computer in the foreground, colored green.
network-transmit-receive	The icon used data is being both transmitted and received simultaneously, while the computing device is connected to a network. This icon should be two computers, one in the background, with the screens of both computers, colored green.
printer-error	The icon used when an error occurs while attempting to print. This icon should be the theme's printer device icon, with the theme's style element for errors, overlayed on top of the icon.
printer-printing	The icon used while a print job is successfully being spooled to a printing device. This icon should be the theme's printer device icon, with a document emerging from the printing device.
security-high	The icon used to indicate that the security level of a connection is known to be secure, using strong encryption and a valid certificate.
security-medium	The icon used to indicate that the security level of a connection is presumed to be secure, using strong encryption, and a certificate that could not be automatically verified, but which the user has chosen to trust.
security-low	The icon used to indicate that the security level of a connection is presumed to be insecure, either by using weak encryption, or by using a certificate that the could not be automatically verified, and which the user has not chosent to trust.
software-update-available	The icon used when an update is available for software installed on the computing device, through the system software update program.
software-update-urgent	The icon used when an urgent update is available through the system software update program.
sync-error	The icon used when an error occurs while attempting to synchronize data from the computing device, to another device.
sync-synchronizing	The icon used while data is successfully synchronizing to another device.
task-due	The icon used when a task is due soon.
task-past-due	The icon used when a task that was due, has been left incomplete.
user-available	The icon used when a user on a chat network is available to initiate a conversation with.
user-away	The icon used when a user on a chat network is away from their keyboard and the chat program.
user-idle	The icon used when a user on a chat network has not been an active participant in any chats on the network, for an extended period of time.
user-offline	The icon used when a user on a chat network is not available.
user-trash-full	The icon for the user's “Trash” in the desktop's file manager, when there are items in the “Trash” waiting for disposal or recovery.
weather-clear	The icon used while the weather for a region is “clear skies”.
weather-clear-night	The icon used while the weather for a region is “clear skies” during the night.
weather-few-clouds	The icon used while the weather for a region is “partly cloudy”.
weather-few-clouds-night	The icon used while the weather for a region is “partly cloudy” during the night.
weather-fog	The icon used while the weather for a region is “foggy”.
weather-overcast	The icon used while the weather for a region is “overcast”.
weather-severe-alert	The icon used while a sever weather alert is in effect for a region.
weather-showers	The icon used while rain showers are occurring in a region.
weather-showers-scattered	The icon used while scattered rain showers are occurring in a region.
weather-snow	The icon used while snow showers are occurring in a region.
weather-storm	The icon used while storms are occurring in a region.
























# from http://doc.qt.io/qt-5/qstyle.html#StandardPixmap-enum
QStyle::SP_TitleBarMinButton	1	Minimize button on title bars (e.g., in QMdiSubWindow).
QStyle::SP_TitleBarMenuButton	0	Menu button on a title bar.
QStyle::SP_TitleBarMaxButton	2	Maximize button on title bars.
QStyle::SP_TitleBarCloseButton	3	Close button on title bars.
QStyle::SP_TitleBarNormalButton	4	Normal (restore) button on title bars.
QStyle::SP_TitleBarShadeButton	5	Shade button on title bars.
QStyle::SP_TitleBarUnshadeButton	6	Unshade button on title bars.
QStyle::SP_TitleBarContextHelpButton	7	The Context help button on title bars.
QStyle::SP_MessageBoxInformation	9	The "information" icon.
QStyle::SP_MessageBoxWarning	10	The "warning" icon.
QStyle::SP_MessageBoxCritical	11	The "critical" icon.
QStyle::SP_MessageBoxQuestion	12	The "question" icon.
QStyle::SP_DesktopIcon	13	The "desktop" icon.
QStyle::SP_TrashIcon	14	The "trash" icon.
QStyle::SP_ComputerIcon	15	The "My computer" icon.
QStyle::SP_DriveFDIcon	16	The floppy icon.
QStyle::SP_DriveHDIcon	17	The harddrive icon.
QStyle::SP_DriveCDIcon	18	The CD icon.
QStyle::SP_DriveDVDIcon	19	The DVD icon.
QStyle::SP_DriveNetIcon	20	The network icon.
QStyle::SP_DirHomeIcon	56	The home directory icon.
QStyle::SP_DirOpenIcon	21	The open directory icon.
QStyle::SP_DirClosedIcon	22	The closed directory icon.
QStyle::SP_DirIcon	38	The directory icon.
QStyle::SP_DirLinkIcon	23	The link to directory icon.
QStyle::SP_DirLinkOpenIcon	24	The link to open directory icon.
QStyle::SP_FileIcon	25	The file icon.
QStyle::SP_FileLinkIcon	26	The link to file icon.
QStyle::SP_FileDialogStart	29	The "start" icon in a file dialog.
QStyle::SP_FileDialogEnd	30	The "end" icon in a file dialog.
QStyle::SP_FileDialogToParent	31	The "parent directory" icon in a file dialog.
QStyle::SP_FileDialogNewFolder	32	The "create new folder" icon in a file dialog.
QStyle::SP_FileDialogDetailedView	33	The detailed view icon in a file dialog.
QStyle::SP_FileDialogInfoView	34	The file info icon in a file dialog.
QStyle::SP_FileDialogContentsView	35	The contents view icon in a file dialog.
QStyle::SP_FileDialogListView	36	The list view icon in a file dialog.
QStyle::SP_FileDialogBack	37	The back arrow in a file dialog.
QStyle::SP_DockWidgetCloseButton	8	Close button on dock windows (see also QDockWidget).
QStyle::SP_ToolBarHorizontalExtensionButton	27	Extension button for horizontal toolbars.
QStyle::SP_ToolBarVerticalExtensionButton	28	Extension button for vertical toolbars.
QStyle::SP_DialogOkButton	39	Icon for a standard OK button in a QDialogButtonBox.
QStyle::SP_DialogCancelButton	40	Icon for a standard Cancel button in a QDialogButtonBox.
QStyle::SP_DialogHelpButton	41	Icon for a standard Help button in a QDialogButtonBox.
QStyle::SP_DialogOpenButton	42	Icon for a standard Open button in a QDialogButtonBox.
QStyle::SP_DialogSaveButton	43	Icon for a standard Save button in a QDialogButtonBox.
QStyle::SP_DialogCloseButton	44	Icon for a standard Close button in a QDialogButtonBox.
QStyle::SP_DialogApplyButton	45	Icon for a standard Apply button in a QDialogButtonBox.
QStyle::SP_DialogResetButton	46	Icon for a standard Reset button in a QDialogButtonBox.
QStyle::SP_DialogDiscardButton	47	Icon for a standard Discard button in a QDialogButtonBox.
QStyle::SP_DialogYesButton	48	Icon for a standard Yes button in a QDialogButtonBox.
QStyle::SP_DialogNoButton	49	Icon for a standard No button in a QDialogButtonBox.
QStyle::SP_ArrowUp	50	Icon arrow pointing up.
QStyle::SP_ArrowDown	51	Icon arrow pointing down.
QStyle::SP_ArrowLeft	52	Icon arrow pointing left.
QStyle::SP_ArrowRight	53	Icon arrow pointing right.
QStyle::SP_ArrowBack	54	Equivalent to SP_ArrowLeft when the current layout direction is Qt::LeftToRight, otherwise SP_ArrowRight.
QStyle::SP_ArrowForward	55	Equivalent to SP_ArrowRight when the current layout direction is Qt::LeftToRight, otherwise SP_ArrowLeft.
QStyle::SP_CommandLink	57	Icon used to indicate a Vista style command link glyph.
QStyle::SP_VistaShield	58	Icon used to indicate UAC prompts on Windows Vista. This will return a null pixmap or icon on all other platforms.
QStyle::SP_BrowserReload	59	Icon indicating that the current page should be reloaded.
QStyle::SP_BrowserStop	60	Icon indicating that the page loading should stop.
QStyle::SP_MediaPlay	61	Icon indicating that media should begin playback.
QStyle::SP_MediaStop	62	Icon indicating that media should stop playback.
QStyle::SP_MediaPause	63	Icon indicating that media should pause playback.
QStyle::SP_MediaSkipForward	64	Icon indicating that media should skip forward.
QStyle::SP_MediaSkipBackward	65	Icon indicating that media should skip backward.
QStyle::SP_MediaSeekForward	66	Icon indicating that media should seek forward.
QStyle::SP_MediaSeekBackward	67	Icon indicating that media should seek backward.
QStyle::SP_MediaVolume	68	Icon indicating a volume control.
QStyle::SP_MediaVolumeMuted	69	Icon indicating a muted volume control.
QStyle::SP_LineEditClearButton	70	Icon for a standard clear button in a QLineEdit. This enum value was added in Qt 5.2.
QStyle::SP_CustomBase	0xf0000000	Base value for custom standard pixmaps; custom values must be greater than this value.
























# List of icons in gnome theme, sample found by looking in /usr/share/icons/gnome/16x16, ignoring symlinks
# find /usr/share/icons/gnome/16x16/ -mindepth 2 ! -type l
./apps/im-yahoo.png
./apps/window.png
./apps/help-browser.png
./apps/utilities-system-monitor.png
./apps/preferences-desktop-theme.png
./apps/im-jabber.png
./apps/user-info.png
./apps/preferences-desktop-font.png
./apps/im-msn.png
./apps/system-file-manager.png
./apps/im-icq.png
./apps/accessories-dictionary.png
./apps/multimedia-volume-control.png
./apps/im.png
./apps/preferences-desktop-locale.png
./apps/accessories-calculator.png
./apps/preferences-desktop-keyboard-shortcuts.png
./apps/logviewer.png
./apps/system-users.png
./apps/web-browser.png
./apps/preferences-desktop-keyboard.png
./apps/accessories-text-editor.png
./apps/system-software-install.png
./apps/im-aim.png
./apps/preferences-desktop-screensaver.png
./apps/utilities-terminal.png
./apps/preferences-desktop-accessibility.png
./apps/preferences-desktop-wallpaper.png
./apps/preferences-desktop-remote-desktop.png
./apps/im-nov.png
./apps/applets-screenshooter.png
./apps/accessories-character-map.png
./apps/preferences-system-windows.png
./apps/system-software-update.png
./emotes/face-surprise.png
./emotes/face-sick.png
./emotes/face-crying.png
./emotes/face-uncertain.png
./emotes/face-cool.png
./emotes/face-wink.png
./emotes/face-angry.png
./emotes/face-angel.png
./emotes/face-raspberry.png
./emotes/face-worried.png
./emotes/face-smile.png
./emotes/face-tired.png
./emotes/face-kiss.png
./emotes/face-smirk.png
./emotes/face-plain.png
./emotes/face-sad.png
./emotes/face-monkey.png
./emotes/face-embarrassed.png
./emotes/face-smile-big.png
./emotes/face-devilish.png
./emotes/face-laugh.png
./categories/preferences-desktop.png
./categories/applications-internet.png
./categories/applications-accessories.png
./categories/preferences-other.png
./categories/preferences-system.png
./categories/applications-multimedia.png
./categories/applications-development.png
./categories/applications-office.png
./categories/preferences-desktop-personal.png
./categories/applications-science.png
./categories/applications-utilities.png
./categories/applications-engineering.png
./categories/applications-system.png
./categories/applications-games.png
./categories/preferences-system-network.png
./categories/applications-other.png
./categories/preferences-desktop-peripherals.png
./categories/applications-graphics.png
./categories/system-help.png
./animations/process-working.png
./actions/gtk-print-report.png
./actions/mail-mark-important.png
./actions/call-start.png
./actions/document-save.png
./actions/media-playback-stop.png
./actions/go-top.png
./actions/document-print-preview.png
./actions/format-indent-less.png
./actions/media-record.png
./actions/mail-mark-unread.png
./actions/format-text-strikethrough.png
./actions/insert-link.png
./actions/document-revert.png
./actions/view-refresh.png
./actions/edit-paste.png
./actions/insert-image.png
./actions/help-contents.png
./actions/folder-new.png
./actions/zoom-original.png
./actions/system-run.png
./actions/go-home.png
./actions/process-stop.png
./actions/document-open.png
./actions/zoom-fit-best.png
./actions/system-search.png
./actions/edit-select-all.png
./actions/appointment-new.png
./actions/object-flip-horizontal.png
./actions/go-last.png
./actions/format-text-underline.png
./actions/view-restore.png
./actions/list-remove.png
./actions/mail-mark-notjunk.png
./actions/tab-new.png
./actions/go-jump.png
./actions/tools-check-spelling.png
./actions/object-rotate-left.png
./actions/format-justify-fill.png
./actions/system-log-out.png
./actions/media-eject.png
./actions/help-faq.png
./actions/media-skip-forward.png
./actions/go-down.png
./actions/view-sort-descending.png
./actions/format-justify-left.png
./actions/system-lock-screen.png
./actions/media-playback-pause.png
./actions/insert-text.png
./actions/mail-reply-sender.png
./actions/document-print.png
./actions/window-new.png
./actions/go-next.png
./actions/media-playback-start.png
./actions/object-flip-vertical.png
./actions/edit-copy.png
./actions/contact-new.png
./actions/zoom-in.png
./actions/edit-delete.png
./actions/document-page-setup.png
./actions/application-exit.png
./actions/document-new.png
./actions/go-previous.png
./actions/gtk-edit.png
./actions/mail-send-receive.png
./actions/go-up.png
./actions/document-open-recent.png
./actions/mail-send.png
./actions/help-about.png
./actions/edit-find.png
./actions/go-first.png
./actions/edit-undo.png
./actions/object-rotate-right.png
./actions/go-bottom.png
./actions/system-shutdown.png
./actions/view-fullscreen.png
./actions/format-justify-center.png
./actions/gtk-print-paused.png
./actions/format-text-italic.png
./actions/window-close.png
./actions/media-seek-backward.png
./actions/format-text-bold.png
./actions/view-sort-ascending.png
./actions/document-send.png
./actions/zoom-out.png
./actions/format-text-direction-rtl.png
./actions/media-skip-backward.png
./actions/gtk-print-warning.png
./actions/address-book-new.png
./actions/mail-forward.png
./actions/gtk-print-error.png
./actions/edit-find-replace.png
./actions/edit-cut.png
./actions/edit-redo.png
./actions/insert-object.png
./actions/format-text-direction-ltr.png
./actions/edit-clear.png
./actions/mail-message-new.png
./actions/document-properties.png
./actions/call-stop.png
./actions/mail-mark-read.png
./actions/bookmark-new.png
./actions/mail-mark-junk.png
./actions/media-seek-forward.png
./actions/mail-reply-all.png
./actions/format-indent-more.png
./actions/document-save-as.png
./actions/list-add.png
./actions/format-justify-right.png
./stock/generic
./stock/generic/stock_trash_full.png
./stock/generic/stock_help-document.png
./stock/generic/stock_score-high.png
./stock/generic/stock_folder-properties.png
./stock/generic/stock_allow-effects.png
./stock/generic/stock_format-page.png
./stock/generic/stock_help-book.png
./stock/generic/stock_help-book-open.png
./stock/generic/stock_send-fax.png
./stock/generic/stock_show-all.png
./stock/generic/stock_anchor.png
./stock/generic/stock_toggle-info.png
./stock/generic/stock_people.png
./stock/generic/stock_folder-move.png
./stock/generic/stock_help-agent.png
./stock/generic/stock_autocompletion.png
./stock/generic/stock_example.png
./stock/generic/stock_color.png
./stock/generic/stock_book_blue.png
./stock/generic/stock_toggle-preview.png
./stock/generic/stock_score-lower.png
./stock/generic/stock_calendar-and-tasks.png
./stock/generic/stock_presentation-styles.png
./stock/generic/stock_help-chat.png
./stock/generic/stock_timer_stopped.png
./stock/generic/stock_flip-horizontally.png
./stock/generic/stock_person.png
./stock/generic/stock_timezone.png
./stock/generic/stock_exit.png
./stock/generic/stock_toilet-paper.png
./stock/generic/stock_styles.png
./stock/generic/stock_test-mode.png
./stock/generic/stock_summary.png
./stock/generic/stock_extended-help.png
./stock/generic/stock_new-24h-appointment.png
./stock/generic/stock_help-add-bookmark.png
./stock/generic/stock_id.png
./stock/generic/stock_equals.png
./stock/generic/stock_book_open.png
./stock/generic/stock_openoffice.png
./stock/generic/stock_edit.png
./stock/generic/stock_flip-vertically.png
./stock/generic/stock_keyring.png
./stock/generic/stock_web-support.png
./stock/generic/stock_score-higher.png
./stock/generic/stock_animation.png
./stock/generic/stock_drag-mode.png
./stock/generic/stock_default-folder.png
./stock/generic/stock_folder-copy.png
./stock/generic/stock_autopilot.png
./stock/generic/stock_bell.png
./stock/generic/stock_presentation-box.png
./stock/generic/stock_mark.png
./stock/generic/stock_new-meeting.png
./stock/generic/stock_notes.png
./stock/generic/stock_timer.png
./stock/generic/stock_active.png
./stock/generic/stock_help-pane-on.png
./stock/generic/stock_web-calendar.png
./stock/generic/stock_3d-favourites.png
./stock/generic/stock_undelete.png
./stock/generic/stock_landline-phone.png
./stock/generic/stock_score-normal.png
./stock/generic/stock_score-low.png
./stock/generic/stock_score-highest.png
./stock/generic/stock_properties.png
./stock/generic/stock_help-pane-off.png
./stock/generic/stock_book_yellow.png
./stock/generic/stock_news.png
./stock/generic/stock_calc-cancel.png
./stock/generic/stock_about.png
./stock/generic/stock_book_red.png
./stock/generic/stock_score-lowest.png
./stock/generic/stock_check-filled.png
./stock/generic/stock_unknown.png
./stock/generic/stock_briefcase.png
./stock/generic/stock_file-properties.png
./stock/generic/stock_notebook.png
./stock/generic/stock_calc-accept.png
./stock/generic/stock_view-details.png
./stock/generic/stock_book_green.png
./stock/form
./stock/form/stock_form-image-control.png
./stock/form/stock_form-pattern-field.png
./stock/form/stock_form-listbox.png
./stock/form/stock_form-currency-field.png
./stock/form/stock_macro-controls.png
./stock/form/stock_insert-form.png
./stock/form/stock_form-progressbar.png
./stock/form/stock_form-numerical-field.png
./stock/form/stock_form-control-properties.png
./stock/form/stock_form-activation-order.png
./stock/form/stock_form-formatted-field.png
./stock/form/stock_form-time-field.png
./stock/form/stock_form-file-selection.png
./stock/form/stock_form-button.png
./stock/form/stock_form-design-mode.png
./stock/form/stock_form-combobox.png
./stock/form/stock_form-checkbox.png
./stock/form/stock_form-letter-dialog.png
./stock/form/stock_form-table-control.png
./stock/form/stock_form-text-box.png
./stock/form/stock_form-properties.png
./stock/form/stock_show-hidden-controls.png
./stock/form/stock_show-form-dialog.png
./stock/form/stock_form-navigator.png
./stock/form/stock_view-fields.png
./stock/form/stock_form-automatic-control-focus.png
./stock/form/stock_form-add-field.png
./stock/form/stock_form-autopilots.png
./stock/form/stock_form-open-in-design-mode.png
./stock/form/stock_form-radio.png
./stock/form/stock_form-frame.png
./stock/form/stock_form-label.png
./stock/form/stock_form-date-field.png
./stock/form/stock_form-image-button.png
./stock/media
./stock/media/stock_headphones.png
./stock/media/stock_line_in.png
./stock/media/stock_effects-sound.png
./stock/media/stock_playlist.png
./stock/media/stock_music-library.png
./stock/media/stock_insert-video-plugin.png
./stock/media/stock_smart-playlist.png
./stock/media/stock_3dsound.png
./stock/media/stock_midi.png
./stock/image
./stock/image/stock_draw-line-with-arrow-circle.png
./stock/image/stock_draw-connector-ends-with-arrow.png
./stock/image/stock_graphics-align-centered.png
./stock/image/stock_filters-solarize.png
./stock/image/stock_node-smooth-to-symmetrical.png
./stock/image/stock_draw-rounded-square.png
./stock/image/stock_draw-connector-with-arrows.png
./stock/image/stock_draw-line-45.png
./stock/image/stock_graphics-align-top.png
./stock/image/stock_draw-line-connector-with-arrows.png
./stock/image/stock_imagemap-editor.png
./stock/image/stock_3d-colors.png
./stock/image/stock_draw-curved-connector-ends-with-arrow.png
./stock/image/stock_draw-straight-connector-ends-with-arrow.png
./stock/image/stock_draw-rectangle.png
./stock/image/stock_draw-circle-segment.png
./stock/image/stock_3d-color-picker.png
./stock/image/stock_draw-line-connector-ends-with-arrow.png
./stock/image/stock_draw-curved-connector-with-arrows.png
./stock/image/stock_draw-line-connector-starts-with-arrow.png
./stock/image/stock_crop.png
./stock/image/stock_modify-layout.png
./stock/image/stock_draw-square-unfilled.png
./stock/image/stock_graphics-align-left.png
./stock/image/stock_draw-straight-connector-with-circles.png
./stock/image/stock_wallpaper-center.png
./stock/image/stock_transform-circle-slant.png
./stock/image/stock_channel-red.png
./stock/image/stock_draw-line-starts-with-arrow.png
./stock/image/stock_graphics-align-bottom.png
./stock/image/stock_draw-rounded-rectangle-unfilled.png
./stock/image/stock_contrast.png
./stock/image/stock_draw-half-sphere.png
./stock/image/stock_draw-line-connector.png
./stock/image/stock_placeholder-text.png
./stock/image/stock_quickmask.png
./stock/image/stock_channel-blue.png
./stock/image/stock_rotate-3d.png
./stock/image/stock_draw-ellipse.png
./stock/image/stock_draw-straight-connector-ends-with-circle.png
./stock/image/stock_guides.png
./stock/image/stock_show-draw-functions.png
./stock/image/stock_draw-curve-filled.png
./stock/image/stock_insert_image.png
./stock/image/stock_draw-ellipse-unfilled.png
./stock/image/stock_flip.png
./stock/image/stock_filters-sharpen.png
./stock/image/stock_draw-circle-arc.png
./stock/image/stock_placeholder-line-contour.png
./stock/image/stock_filters-invert.png
./stock/image/stock_placeholder-picture.png
./stock/image/stock_graphics-align-right.png
./stock/image/stock_3d-effects.png
./stock/image/stock_linepen.png
./stock/image/stock_graphic-styles.png
./stock/image/stock_draw-torus.png
./stock/image/stock_draw-curved-connector-ends-with-circle.png
./stock/image/stock_draw-line-with-square-arrow.png
./stock/image/stock_wallpaper-scale.png
./stock/image/stock_draw-ellipse-segment.png
./stock/image/stock_node-mark-for-deletion.png
./stock/image/stock_gradient.png
./stock/image/stock_draw-curved-connector-with-circles.png
./stock/image/stock_draw-connector.png
./stock/image/stock_draw-circle-unfilled.png
./stock/image/stock_node-add.png
./stock/image/stock_draw-circle-segment-unfilled.png
./stock/image/stock_draw-arc.png
./stock/image/stock_3d-custom-color.png
./stock/image/stock_draw-rectangle-unfilled.png
./stock/image/stock_draw-rounded-rectangle.png
./stock/image/stock_draw-straight-connector-starts-with-arrow.png
./stock/image/stock_toggle-graphics.png
./stock/image/stock_filters-aging.png
./stock/image/stock_wallpaper-tile.png
./stock/image/stock_draw-square.png
./stock/image/stock_draw-line-connector-ends-with-circle.png
./stock/image/stock_display-grid.png
./stock/image/stock_draw-connector-starts-with-arrow.png
./stock/image/stock_rotate.png
./stock/image/stock_node-delete.png
./stock/image/stock_shadow.png
./stock/image/stock_draw-line-with-arrows.png
./stock/image/stock_draw-curved-connector.png
./stock/image/stock_draw-curved-connector-starts-with-circle.png
./stock/image/stock_brightness.png
./stock/image/stock_draw-freeform-line.png
./stock/image/stock_draw-line-connector-starts-with-circle.png
./stock/image/stock_filters-smooth.png
./stock/image/stock_draw-polygon-45-filled.png
./stock/image/stock_wallpaper-fill.png
./stock/image/stock_node-convert.png
./stock/image/stock_draw-cone.png
./stock/image/stock_draw-connector-with-circles.png
./stock/image/stock_filters-remove-noise.png
./stock/image/stock_draw-cylinder.png
./stock/image/stock_draw-connector-starts-with-circle.png
./stock/image/stock_draw-callouts.png
./stock/image/stock_draw-polygon.png
./stock/image/stock_filters-pop-art.png
./stock/image/stock_draw-pyramid.png
./stock/image/stock_node-curve-split.png
./stock/image/stock_draw-rounded-square-unfilled.png
./stock/image/stock_draw-polygon-filled.png
./stock/image/stock_node-close-path.png
./stock/image/stock_draw-sphere.png
./stock/image/stock_draw-selection.png
./stock/image/stock_draw-circle.png
./stock/image/stock_draw-straight-connector.png
./stock/image/stock_transparency.png
./stock/image/stock_draw-line-with-circle-arrow.png
./stock/image/stock_node-corner-to-smooth.png
./stock/image/stock_draw-freeform-line-filled.png
./stock/image/stock_draw-dimension-line.png
./stock/image/stock_draw-polygon-45.png
./stock/image/stock_filters-posterize.png
./stock/image/stock_display-guides.png
./stock/image/stock_draw-circle-pie-unfilled.png
./stock/image/stock_edit-points.png
./stock/image/stock_draw-ellipse-segment-unfilled.png
./stock/image/stock_gamma.png
./stock/image/stock_draw-line-connector-with-circles.png
./stock/image/stock_draw-line-ends-with-arrow.png
./stock/image/stock_bucketfill.png
./stock/image/stock_draw-line-with-arrow-square.png
./stock/image/stock_draw-straight-connector-starts-with-circle.png
./stock/image/stock_draw-curve.png
./stock/image/stock_draw-connector-ends-with-circle.png
./stock/image/stock_draw-curved-connector-starts-with-arrow.png
./stock/image/stock_graphics-align-center.png
./stock/image/stock_draw-cube.png
./stock/image/stock_draw-ellipse-pie.png
./stock/image/stock_filters-relief.png
./stock/image/stock_draw-line.png
./stock/image/stock_placeholder-graphic.png
./stock/image/stock_draw-circle-pie.png
./stock/image/stock_draw-shell.png
./stock/image/stock_transform-circle-perspective.png
./stock/image/stock_filters-charcoal.png
./stock/image/stock_filters-pixelize.png
./stock/image/stock_channel-green.png
./stock/image/stock_node-move.png
./stock/image/stock_draw-vertical-callouts.png
./stock/image/stock_draw-ellipse-pie-unfilled.png
./stock/image/stock_rotation-mode.png
./stock/image/stock_arrowstyle.png
./stock/image/stock_draw-straight-connector-with-arrows.png
./stock/image/stock_distort.png
./stock/image/stock_node-corner.png
./stock/net
./stock/net/stock_hand-signed.png
./stock/net/stock_message-display.png
./stock/net/stock_directory-server.png
./stock/net/stock_disconnect.png
./stock/net/stock_connect.png
./stock/net/stock_mail-import.png
./stock/net/stock_shared-by-me.png
./stock/net/stock_mail-unread-multiple.png
./stock/net/stock_hyperlink-toolbar.png
./stock/net/stock_channel.png
./stock/net/stock_internet.png
./stock/net/stock_insert-url.png
./stock/net/stock_hyperlink-internet-search.png
./stock/net/stock_mail-accounts.png
./stock/net/stock_mail-open.png
./stock/net/stock_mail-hide-selected.png
./stock/net/stock_mail.png
./stock/net/stock_mail-filters-apply.png
./stock/net/stock_sent-mail.png
./stock/net/stock_groupwise-connector.png
./stock/net/stock_mail-move.png
./stock/net/stock_mail-handling.png
./stock/net/stock_video-conferencing.png
./stock/net/stock_mail-hide-read.png
./stock/net/stock_addressbook.png
./stock/net/stock_mail-replied.png
./stock/net/stock_link.png
./stock/net/stock_hyperlink.png
./stock/net/stock_mail-send.png
./stock/net/stock_mail-copy.png
./stock/net/stock_mail-hide-deleted.png
./stock/net/stock_exchange-connector.png
./stock/net/stock_connect-to-url.png
./stock/net/stock_mail-merge.png
./stock/net/stock_mail-open-multiple.png
./stock/net/stock_hyperlink-target.png
./stock/net/stock_shared-to-me.png
./stock/net/stock_contact-list.png
./stock/net/stock_mail-unread.png
./stock/net/stock_mail-receive.png
./stock/net/stock_post-message.png
./stock/net/stock_mail-flag-for-followup-done.png
./stock/net/stock_inbox.png
./stock/net/stock_mail-flag-for-followup.png
./stock/net/stock_online-layout.png
./stock/net/stock_contact.png
./stock/net/stock_outbox.png
./stock/navigation
./stock/navigation/stock_navigator-scenarios.png
./stock/navigation/stock_navigator-open-toolbar.png
./stock/navigation/stock_navigator-foonote-body-toggle.png
./stock/navigation/stock_zoom-previous.png
./stock/navigation/stock_first-page.png
./stock/navigation/stock_previous-page.png
./stock/navigation/stock_navigator-sections.png
./stock/navigation/stock_undo-history.png
./stock/navigation/stock_zoom-next.png
./stock/navigation/stock_navigator-reminder.png
./stock/navigation/stock_last-page.png
./stock/navigation/stock_navigator-range-names.png
./stock/navigation/stock_navigator-insert-index.png
./stock/navigation/stock_navigator-database-ranges.png
./stock/navigation/stock_navigator-insert-as-copy.png
./stock/navigation/stock_navigator-shift-left.png
./stock/navigation/stock_navigator-footer-body-toggle.png
./stock/navigation/stock_zoom-page.png
./stock/navigation/stock_previous.png
./stock/navigation/stock_navigate-prev.png
./stock/navigation/stock_zoom-page-width.png
./stock/navigation/stock_zoom-optimal.png
./stock/navigation/stock_navigator-indexes.png
./stock/navigation/stock_navigator-edit-entry.png
./stock/navigation/stock_next-page.png
./stock/navigation/stock_navigator-wrong-table-formula.png
./stock/navigation/stock_live-mode.png
./stock/navigation/stock_navigator-headings.png
./stock/navigation/stock_navigator-insert-linked.png
./stock/navigation/stock_navigator.png
./stock/navigation/stock_navigator-shift-up.png
./stock/navigation/stock_navigator-all-or-sel-toggle.png
./stock/navigation/stock_navigator-insert-as-link.png
./stock/navigation/stock_navigator-shift-right.png
./stock/navigation/stock_zoom-shift.png
./stock/navigation/stock_zoom-object.png
./stock/navigation/stock_navigator-list-box-toggle.png
./stock/navigation/stock_navigator-shift-down.png
./stock/navigation/stock_next.png
./stock/navigation/stock_navigator-references.png
./stock/navigation/stock_navigator-next-object.png
./stock/navigation/stock_navigator-drag-mode.png
./stock/navigation/stock_down-with-subpoints.png
./stock/navigation/stock_navigator-update-entry.png
./stock/navigation/stock_navigator-table-formula.png
./stock/navigation/stock_navigator-previous-object.png
./stock/navigation/stock_left-with-subpoints.png
./stock/navigation/stock_up-with-subpoints.png
./stock/navigation/stock_navigator-master-toggle.png
./stock/navigation/stock_navigate-next.png
./stock/navigation/stock_right-with-subpoints.png
./stock/navigation/stock_navigator-header-body-toggle.png
./stock/navigation/stock_zoom.png
./stock/navigation/stock_navigator-text.png
./stock/navigation/stock_navigator-levels.png
./stock/table
./stock/table/stock_ungroup-cells.png
./stock/table/stock_select-row.png
./stock/table/stock_exchange-columns.png
./stock/table/stock_insert-cells.png
./stock/table/stock_insert-rows.png
./stock/table/stock_sort-table-column-ascending.png
./stock/table/stock_table-fixed.png
./stock/table/stock_select-table.png
./stock/table/stock_table-fit-width.png
./stock/table/stock_cell-align-bottom.png
./stock/table/stock_cell-align-top.png
./stock/table/stock_insert-cells-right.png
./stock/table/stock_alignment-centered.png
./stock/table/stock_sort-table-row-ascending.png
./stock/table/stock_insert-table.png
./stock/table/stock_table-fixed-proportional.png
./stock/table/stock_delete-column.png
./stock/table/stock_alignment-bottom.png
./stock/table/stock_table-optimize.png
./stock/table/stock_cell-align-center.png
./stock/table/stock_table_borders.png
./stock/table/stock_table-fit-height.png
./stock/table/stock_table-combine.png
./stock/table/stock_alignment-right.png
./stock/table/stock_select-column.png
./stock/table/stock_table-split.png
./stock/table/stock_group-cells.png
./stock/table/stock_table-align-center.png
./stock/table/stock_table-variable.png
./stock/table/stock_alignment-top.png
./stock/table/stock_alignment-centered-vertically.png
./stock/table/stock_table-line-color.png
./stock/table/stock_alignment.png
./stock/table/stock_exchange-rows.png
./stock/table/stock_table-same-height.png
./stock/table/stock_table-align-top.png
./stock/table/stock_insert-names-define.png
./stock/table/stock_table-borders.png
./stock/table/stock_delete-row.png
./stock/table/stock_insert-cells-down.png
./stock/table/stock_table-same-width.png
./stock/table/stock_table-line-style.png
./stock/table/stock_alignment-left.png
./stock/table/stock_choose-themes.png
./stock/table/stock_table-align-bottom.png
./stock/table/stock_insert-columns.png
./stock/table/stock_table_fill.png
./stock/table/stock_datapilot.png
./stock/table/stock_select-cell.png
./stock/data
./stock/data/stock_data-delete-record.png
./stock/data/stock_update-data.png
./stock/data/stock_goal-seek.png
./stock/data/stock_data-sources-delete.png
./stock/data/stock_lock-ok.png
./stock/data/stock_data-explorer.png
./stock/data/stock_data-last.png
./stock/data/stock_data-new-link.png
./stock/data/stock_data-table.png
./stock/data/stock_delete-decimal-place.png
./stock/data/stock_filter-navigator.png
./stock/data/stock_data-new-record.png
./stock/data/stock_data-edit-table.png
./stock/data/stock_autofilter.png
./stock/data/stock_data-undo.png
./stock/data/stock_data-delete-query.png
./stock/data/stock_data-first.png
./stock/data/stock_sort-ascending.png
./stock/data/stock_add-decimal-place.png
./stock/data/stock_data-linked-table.png
./stock/data/stock_data-new-table.png
./stock/data/stock_data-new-query.png
./stock/data/stock_lock-open.png
./stock/data/stock_data-save.png
./stock/data/stock_data-links.png
./stock/data/stock_data-sources.png
./stock/data/stock_lock.png
./stock/data/stock_data-delete-table.png
./stock/data/stock_data-query-rename.png
./stock/data/stock_signature.png
./stock/data/stock_data-delete-sql-query.png
./stock/data/stock_filter-data-by-criteria.png
./stock/data/stock_data-sources-hand.png
./stock/data/stock_advanced-filter.png
./stock/data/stock_filters.png
./stock/data/stock_data-link.png
./stock/data/stock_standard-filter.png
./stock/data/stock_data-sources-modified.png
./stock/data/stock_data-edit-query.png
./stock/data/stock_data-next.png
./stock/data/stock_data-edit-link.png
./stock/data/stock_database.png
./stock/data/stock_format-percent.png
./stock/data/stock_format-default.png
./stock/data/stock_lock-broken.png
./stock/data/stock_signature-ok.png
./stock/data/stock_data-tables.png
./stock/data/stock_sort-descending.png
./stock/data/stock_data-delete-link.png
./stock/data/stock_function-autopilot.png
./stock/data/stock_data-queries.png
./stock/data/stock_data-query.png
./stock/data/stock_data-previous.png
./stock/data/stock_data-edit-sql-query.png
./stock/data/stock_sum.png
./stock/data/stock_sort-column-ascending.png
./stock/data/stock_delete-autofilter.png
./stock/data/stock_format-scientific.png
./stock/data/stock_record-number.png
./stock/data/stock_sort-criteria.png
./stock/data/stock_data-new-sql-query.png
./stock/data/stock_insert-fields.png
./stock/data/stock_data-sources-new.png
./stock/data/stock_signature-bad.png
./stock/data/stock_sort-row-ascending.png
./stock/object
./stock/object/stock_insert-floating-frame.png
./stock/object/stock_object-infront.png
./stock/object/stock_handles-simple.png
./stock/object/stock_insert-slide.png
./stock/object/stock_3d-normals-object-specific.png
./stock/object/stock_effects.png
./stock/object/stock_snap-margins.png
./stock/object/stock_reverse-order.png
./stock/object/stock_symbol-selection.png
./stock/object/stock_new-bcard.png
./stock/object/stock_file-with-objects.png
./stock/object/stock_3d-normals-flat.png
./stock/object/stock_3d-all-attributes.png
./stock/object/stock_object-behind.png
./stock/object/stock_slide-showhide.png
./stock/object/stock_bring-backward.png
./stock/object/stock_3d-light-on.png
./stock/object/stock_to-top.png
./stock/object/stock_frame.png
./stock/object/stock_insert_graphic.png
./stock/object/stock_to-curve.png
./stock/object/stock_3d-geometry.png
./stock/object/stock_3d-texture-and-shading.png
./stock/object/stock_format-object.png
./stock/object/stock_edit-bookmark.png
./stock/object/stock_3d-texture-only.png
./stock/object/stock_slide-show.png
./stock/object/stock_insert-single-column-text-frame.png
./stock/object/stock_position-size.png
./stock/object/stock_insert-math-object.png
./stock/object/stock_3d-light.png
./stock/object/stock_handles-big.png
./stock/object/stock_3d-perspective.png
./stock/object/stock_delete-bookmark.png
./stock/object/stock_3d-material.png
./stock/object/stock_insert-gluepoint.png
./stock/object/stock_effects-object-hide.png
./stock/object/stock_effects-object-colorize.png
./stock/object/stock_formula-cursor.png
./stock/object/stock_insert-plugin.png
./stock/object/stock_bring-forward.png
./stock/object/stock_insert-applet.png
./stock/object/stock_snap-object-points.png
./stock/object/stock_snap-guides.png
./stock/object/stock_insert-text-frame.png
./stock/object/stock_insert_special_character.png
./stock/object/stock_to-3d.png
./stock/object/stock_3d-normals-spherical.png
./stock/object/stock_effects-play-in-full.png
./stock/object/stock_3d-texture-spherical.png
./stock/object/stock_to-polygon.png
./stock/object/stock_insert-note.png
./stock/object/stock_effects-preview.png
./stock/object/stock_3d-normals-double-sided-closed-body.png
./stock/object/stock_insert-ole-object.png
./stock/object/stock_3d-3d-attributes-only.png
./stock/object/stock_unlink.png
./stock/object/stock_3d-texture-object-specific.png
./stock/object/stock_view-function-selection.png
./stock/object/stock_insert-sound-plugin.png
./stock/object/stock_enter-group.png
./stock/object/stock_slide-expand.png
./stock/object/stock_3d-texture.png
./stock/object/stock_3d-normals-double-sided.png
./stock/object/stock_snap-object.png
./stock/object/stock_to-3d-rotation-object.png
./stock/object/stock_3d-normals-flip-illumination.png
./stock/object/stock_3d-light-off.png
./stock/object/stock_effects-object.png
./stock/object/stock_interaction.png
./stock/object/stock_auto-contour.png
./stock/object/stock_group.png
./stock/object/stock_snap-grid.png
./stock/object/stock_ungroup.png
./stock/object/stock_pin.png
./stock/object/stock_slide-reherse-timings.png
./stock/object/stock_3d-texture-parallel.png
./stock/object/stock_3d-shading.png
./stock/object/stock_create-with-attributes.png
./stock/object/stock_to-bottom.png
./stock/object/stock_bookmark.png
./stock/object/stock_slide-design.png
./stock/object/stock_insert-rule.png
./stock/object/stock_exit-group.png
./stock/object/stock_effects-more-options.png
./stock/object/stock_slide-duplicate.png
./stock/io
./stock/io/stock_insert-file.png
./stock/io/stock_print-preview-print.png
./stock/io/stock_open-read-only.png
./stock/io/stock_save-pdf.png
./stock/io/stock_save-template.png
./stock/io/stock_print-driver.png
./stock/io/stock_up-one-dir.png
./stock/io/stock_printers.png
./stock/io/stock_network-printer.png
./stock/io/stock_reload.png
./stock/io/stock_export.png
./stock/io/stock_print-setup.png
./stock/code
./stock/code/stock_macro-jump-back.png
./stock/code/stock_macro-insert.png
./stock/code/stock_error-next.png
./stock/code/stock_tools-macro.png
./stock/code/stock_run-macro.png
./stock/code/stock_macro-check-brackets.png
./stock/code/stock_macro-insert-breakpoint.png
./stock/code/stock_macro-objects.png
./stock/code/stock_error-previous.png
./stock/code/stock_record-macro.png
./stock/code/stock_script.png
./stock/code/stock_macro-watch-variable.png
./stock/code/stock_compile.png
./stock/code/stock_macro-organizer.png
./stock/code/stock_macro-stop-after-command.png
./stock/code/stock_macro-stop-watching.png
./stock/code/stock_macro-stop-after-procedure.png
./stock/text
./stock/text/stock_insert_index_marker.png
./stock/text/stock_text-direction-ttb.png
./stock/text/stock_fontwork.png
./stock/text/stock_nonprinting-chars.png
./stock/text/stock_update-fields.png
./stock/text/stock_fontwork-adaptation-off.png
./stock/text/stock_text_color_foreground.png
./stock/text/stock_to-background.png
./stock/text/stock_list_enum-off.png
./stock/text/stock_format-character.png
./stock/text/stock_font-size.png
./stock/text/stock_edit-contour.png
./stock/text/stock_page-total-number.png
./stock/text/stock_decrease-font.png
./stock/text/stock_wrap-optimal.png
./stock/text/stock_list-insert-unnumbered.png
./stock/text/stock_text-outline.png
./stock/text/stock_line-spacing-2.png
./stock/text/stock_wrap-left.png
./stock/text/stock_insert-footer.png
./stock/text/stock_insert_footnote.png
./stock/text/stock_styles-frame-styles.png
./stock/text/stock_format-paragraph.png
./stock/text/stock_autospellcheck.png
./stock/text/stock_fontwork-reverse-text-flow.png
./stock/text/stock_autotext.png
./stock/text/stock_text_color_background.png
./stock/text/stock_thesaurus.png
./stock/text/stock_fontwork-shadow-angle.png
./stock/text/stock_fontwork-shadow-x-offset.png
./stock/text/stock_font.png
./stock/text/stock_insert-fields-subject.png
./stock/text/stock_text-direction-ltr.png
./stock/text/stock_draw-text.png
./stock/text/stock_text_underlined-double.png
./stock/text/stock_styles-fill-format-mode.png
./stock/text/stock_fontwork-spline-distance.png
./stock/text/stock_wrap-behind.png
./stock/text/stock_fontwork-3dshadow.png
./stock/text/stock_insert-fields-title.png
./stock/text/stock_chart-scale-text.png
./stock/text/stock_text-monospaced.png
./stock/text/stock_insert_section.png
./stock/text/stock_list_bullet.png
./stock/text/stock_wrap-contour.png
./stock/text/stock_fontwork-shadow-length.png
./stock/text/stock_fontwork-align-fill.png
./stock/text/stock_insert-caption.png
./stock/text/stock_insert_endnote.png
./stock/text/stock_view-field-shadings.png
./stock/text/stock_fontwork-2dshadow.png
./stock/text/stock_format-numbering-bullets.png
./stock/text/stock_line-spacing-1.5.png
./stock/text/stock_font-formatting-toggle.png
./stock/text/stock_fontwork-adaptation-straight.png
./stock/text/stock_spellcheck.png
./stock/text/stock_draw-vertical-text-frame.png
./stock/text/stock_text-select-text-only.png
./stock/text/stock_increase-font.png
./stock/text/stock_fontwork-adaptation-slant-v.png
./stock/text/stock_list_enum-restart.png
./stock/text/stock_directcursor.png
./stock/text/stock_paragraph-spacing-increase.png
./stock/text/stock_text_color_hilight.png
./stock/text/stock_tools-hyphenation.png
./stock/text/stock_text-spacing.png
./stock/text/stock_euro.png
./stock/text/stock_insert-header.png
./stock/text/stock_effects-text.png
./stock/text/stock_superscript.png
./stock/text/stock_styles-paragraph-styles.png
./stock/text/stock_line-spacing-1.png
./stock/text/stock_autoformat.png
./stock/text/stock_styles-new-style-from-selection.png
./stock/text/stock_subscript.png
./stock/text/stock_fontwork-adaptation-rotate.png
./stock/text/stock_wrap-around.png
./stock/text/stock_text-double-click-to-edit.png
./stock/text/stock_insert-cross-reference.png
./stock/text/stock_fontwork-adaptation-slant-h.png
./stock/text/stock_fontwork-spline-indent.png
./stock/text/stock_fontwork-text-border.png
./stock/text/stock_styles-character-styles.png
./stock/text/stock_draw-text-animation.png
./stock/text/stock_draw-text-frame.png
./stock/text/stock_insert-fields-author.png
./stock/text/stock_wrap-right.png
./stock/text/stock_page-number.png
./stock/text/stock_fontwork-preview-spline.png
./stock/text/stock_list_enum.png
./stock/text/stock_styles-update-style.png
./stock/text/stock_fontwork-shadow-y-offset.png
./stock/text/stock_draw-vertical-text.png
./stock/text/stock_wrap-interrupt.png
./stock/text/stock_paragraph-spacing-decrease.png
./stock/text/stock_to-foreground.png
./stock/text/stock_edit-headers-and-footers.png
./stock/text/stock_styles-numbering-styles.png
./stock/text/stock_styles-page-styles.png
./stock/text/stock_text-quickedit.png
./stock/text/stock_fontwork-noshadow.png
./stock/text/stock_text-shadow.png
./stock/emoticons
./stock/emoticons/stock_smiley-21.png
./stock/emoticons/stock_smiley-19.png
./stock/emoticons/stock_smiley-24.png
./stock/emoticons/stock_smiley-23.png
./stock/emoticons/stock_smiley-14.png
./stock/emoticons/stock_smiley-16.png
./stock/emoticons/stock_smiley-9.png
./stock/emoticons/stock_smiley-25.png
./stock/emoticons/stock_smiley-17.png
./stock/emoticons/stock_smiley-20.png
./stock/emoticons/stock_smiley-26.png
./stock/document
./stock/document/stock_todo.png
./stock/document/stock_new-text.png
./stock/document/stock_new.png
./stock/document/stock_view-html-source.png
./stock/document/stock_new-master-document.png
./stock/document/stock_new-presentation.png
./stock/document/stock_print-resolution.png
./stock/document/stock_new-spreadsheet.png
./stock/document/stock_task.png
./stock/document/stock_print-options.png
./stock/document/stock_new-html.png
./stock/document/stock_print-layout.png
./stock/document/stock_new-labels.png
./stock/document/stock_task-recurring.png
./stock/document/stock_new-drawing.png
./stock/document/stock_task-assigned.png
./stock/document/stock_script.png
./stock/document/stock_task-assigned-to.png
./stock/document/stock_preview-two-pages.png
./stock/document/stock_new-formula.png
./stock/document/stock_scripts.png
./stock/document/stock_certificate.png
./stock/document/stock_preview-four-pages.png
./stock/document/stock_new-template.png
./stock/chart
./stock/chart/stock_chart-data-in-columns.png
./stock/chart/stock_chart-toggle-legend.png
./stock/chart/stock_gluepoint-down.png
./stock/chart/stock_chart-data-in-rows.png
./stock/chart/stock_gluepoint-right.png
./stock/chart/stock_chart-toggle-title.png
./stock/chart/stock_gluepoint-vertical-center.png
./stock/chart/stock_chart-autoformat.png
./stock/chart/stock_chart-toggle-hgrid.png
./stock/chart/stock_chart-toggle-axes-title.png
./stock/chart/stock_gluepoint-horizontal-right.png
./stock/chart/stock_chart-edit-type.png
./stock/chart/stock_insert-chart.png
./stock/chart/stock_gluepoint-left.png
./stock/chart/stock_gluepoint-horizontal-left.png
./stock/chart/stock_chart-toggle-axes.png
./stock/chart/stock_gluepoint-up.png
./stock/chart/stock_gluepoint-vertical-top.png
./stock/chart/stock_gluepoint-relative.png
./stock/chart/stock_glue.png
./stock/chart/stock_chart-toggle-vgrid.png
./stock/chart/stock_chart-reorganize.png
./stock/chart/stock_gluepoint-horizontal-center.png
./stock/chart/stock_gluepoint-vertical-bottom.png
./emblems/emblem-mail.png
./emblems/emblem-default.png
./emblems/emblem-new.png
./emblems/emblem-generic.png
./emblems/emblem-system.png
./emblems/emblem-readonly.png
./emblems/emblem-symbolic-link.png
./emblems/emblem-downloads.png
./emblems/emblem-documents.png
./emblems/emblem-photos.png
./emblems/emblem-urgent.png
./emblems/emblem-package.png
./emblems/emblem-web.png
./emblems/emblem-unreadable.png
./emblems/emblem-shared.png
./emblems/emblem-important.png
./emblems/emblem-favorite.png
./devices/media-flash.png
./devices/computer.png
./devices/drive-removable-media-flash-cf.png
./devices/media-zip.png
./devices/drive-removable-media-flash-sd.png
./devices/media-tape.png
./devices/media-flash-sd.png
./devices/input-keyboard.png
./devices/drive-removable-media-flash.png
./devices/input-tablet.png
./devices/drive-encrypted.png
./devices/printer.png
./devices/media-optical-audio.png
./devices/drive-removable-media-floppy.png
./devices/drive-harddisk-ieee1394.png
./devices/drive-removable-media-ieee1394.png
./devices/audio-input-microphone.png
./devices/media-optical-dvd.png
./devices/audio-card.png
./devices/media-encrypted.png
./devices/drive-removable-media-flash-sm.png
./devices/media-flash-sm.png
./devices/camera-video.png
./devices/network-wired.png
./devices/drive-removable-media-flash-ms.png
./devices/media-flash-ms.png
./devices/multimedia-player.png
./devices/media-optical.png
./devices/drive-harddisk-usb.png
./devices/drive-optical-recorder.png
./devices/media-flash-cf.png
./devices/modem.png
./devices/drive-optical.png
./devices/network-wireless.png
./devices/battery.png
./devices/drive-harddisk.png
./devices/media-optical-hddvd.png
./devices/phone.png
./devices/camera-photo.png
./devices/pda.png
./devices/media-optical-cd.png
./devices/input-gaming.png
./devices/media-optical-bd.png
./devices/media-floppy.png
./devices/scanner.png
./devices/input-mouse.png
./devices/drive-removable-media-usb.png
./devices/video-display.png
./devices/camera-web.png
./devices/drive-removable-media.png
./places/user-desktop.png
./places/folder-remote.png
./places/network-server.png
./places/network-workgroup.png
./places/user-trash.png
./places/folder-saved-search.png
./places/folder.png
./places/start-here.png
./places/user-home.png
./places/folder.icon
./places/user-bookmarks.png
./filesystems/gnome-fs-bookmark-missing.png
./filesystems/gnome-fs-bookmark.png
./mimetypes/audio-x-generic.png
./mimetypes/package-x-generic.png
./mimetypes/x-office-spreadsheet.png
./mimetypes/text-x-preview.png
./mimetypes/image-x-generic.png
./mimetypes/text-x-script.png
./mimetypes/x-office-drawing.png
./mimetypes/x-office-document.png
./mimetypes/text-x-generic.png
./mimetypes/x-office-presentation.png
./mimetypes/text-x-generic-template.png
./mimetypes/application-certificate.png
./mimetypes/x-office-calendar.png
./mimetypes/x-office-address-book.png
./mimetypes/font-x-generic.png
./mimetypes/text-html.png
./mimetypes/video-x-generic.png
./mimetypes/application-x-executable.png
./status/weather-few-clouds.png
./status/network-error.png
./status/weather-storm.png
./status/weather-few-clouds-night.png
./status/folder-drag-accept.png
./status/audio-volume-muted.png
./status/user-trash-full.png
./status/audio-volume-high.png
./status/folder-open.png
./status/network-offline.png
./status/dialog-warning.png
./status/mail-signed-verified.png
./status/mail-replied.png
./status/dialog-information.png
./status/security-low.png
./status/weather-clear.png
./status/network-transmit.png
./status/software-update-urgent.png
./status/security-medium.png
./status/mail-unread.png
./status/printer-printing.png
./status/weather-severe-alert.png
./status/network-receive.png
./status/mail-read.png
./status/printer-error.png
./status/mail-signed.png
./status/weather-clear-night.png
./status/image-missing.png
./status/dialog-password.png
./status/media-playlist-shuffle.png
./status/dialog-question.png
./status/task-past-due.png
./status/folder-visiting.png
./status/audio-volume-medium.png
./status/appointment-missed.png
./status/task-due.png
./status/weather-snow.png
./status/mail-attachment.png
./status/security-high.png
./status/battery-caution.png
./status/media-playlist-repeat.png
./status/dialog-error.png
./status/weather-overcast.png
./status/weather-showers-scattered.png
./status/appointment-soon.png
./status/network-transmit-receive.png
./status/battery-low.png
./status/weather-showers.png
./status/audio-volume-low.png
./status/weather-fog.png
./status/image-loading.png
./status/network-wireless-encrypted.png
./status/software-update-available.png
./status/network-idle.png